2 13 31
###############################
#p * *        *  ** * *      *#
# # # # #*# # #*# # # #1# #*# #
#    * * *** **      *    **  #
# #*# # # # # # #b# # # # # #*#
#        2 *     **      *  **#
# # #*# # # # # #*#*#*#*# # # #
#   *        *   * *x* *      #
# # # # #*# # # # # #2#*# #*# #
#   ****         *            #
# # # # # #1# # # #*# # # # #*#
#  ** *   *                  2#
###############################