2 13 31
###############################
#p * *        *  ** * *      *#
# # # # #*# # #*# # # #1# #*# #
#    * * *** **      *    **  #
# #*# # # # # # #b# # # # # #*#
#        2 *     **      *  **#
# # #*# # # # # #*#*#*#*# #2# #
#   *        *   * *x* *      #
# # # # #*# # # # # # #*# #*# #
#   ****         *            #
# #1# # # #1# # # #*# # # # #*#
#  ** *   *                  2#
###############################